F 220,100,0
NO ./textures/wall.xpm
SO ./textures/wall2.xpm
WE ./textures/wall3.xpm
EA ./textures/wall3.xpm
C 225,30,0 

1111111111111111111111
1100100101001010000001
1000000000000000N01111
1111111111100000011111
       100000000000111
       111111111111111