F 220,100,0
NO ./textures/wall.xpm
SO ./textures/wall2.xpm
WE ./textures/wall3.xpm
EA ./textures/wall3.xpm
C 225,30,0 

        111111
        100001
        100001
        100001
        100001
        100001
        100001
        100001
  111111100001111111
 11000000000000000011
1110000000000000000111
 11000000000000000011
  111111000001111111
        11111