F 173,164,140
NO ./textures/wall2.xpm
SO ./textures/wall2.xpm
WE ./textures/wall.xpm
EA ./textures/wall2.xpm
F 225,30,0 

        111111
        100001
        100001
        100001
        100001
        100001
        100001
        100001
  111111100001111111
 11000000000000000011
1110000000000000000111
 11000001111100000011
  111111     1111111